OOOOOOOOOOOOOOOO
OSOOOOOOOOOOOOOO
O%OOOOOOOOOOOOOO
OOOOOOOOOOOOOOOO
OOOOOOOOOOOO%%OO
OOOOOOOO%%OO%%OO
OOOOO%%O%%OO%%OO
O%O%%%%O%%OO%%OO