%%%%%%%%%%%%%%%%
%%%%%%%%%%%%%%%%
%S%%%%%%%%%%%%XX
%%%%%%%%%%%%%%%%
%%%%%%%%%%%%%XX%
%%%%%%%%%%XXXX%X
%%%%%%%XX%XXX%XX
%%%%XXXXXXX%XXXX